#-#   #-#-*      
  |   | |        
  #-#-#-#-#      
  | | |   |      
#-#-# #   #-#    
  |   |   |      
  #-#-#   #      
  |   |   |      
  #-#-#-$-#-#-#-*
  |     |   |    
#-#-#   #   #    
|   |   |   |    
#-#-#   #   #    
    |   |        
    #-#-#-#-#-#  
      |     | |  
    #-#     # #  